		NO ./path_to_the_north_texture

SO ./path_to_the_south_texture

		WE ./path_to_the_west_texture

EA ./path_to_the_east_texture

	F 	 		  220, 100, 0 
			C 				225,30,0





1111111111111111111111111
1000000000110000000000001
1011000001110000000000001
1001000000000000000000001
111000001110000000000001
11000001110111111111111
111111111011100000010001
11111011101010010001
11111111111111111111111111111111
11111000000110101011100000010001
10011100000000000001100000000001
1000001110000000000110101001000111
11000001111101010111110111100N00001
11110111 1110101 10111101000111111
11111111 1111111 111111111111
