NO ./wallTexture/tex_proto/prototype_B.png
SO ./wallTexture/tex_proto/prototype_B.png
WE ./wallTexture/tex_proto/prototype_B.png
EA ./wallTexture/tex_proto/prototype_B.png

C 199, 0, 57

F 88, 24, 69




1111111111111111111111111111111111111111111111111111111111111111111111111111111111111111111111111
1000000000000000000000000000000000000000000000000000000000000000000000000000000000000000000000001
1000000000000000000000000000100000000000000000000000000000000000000000000000000000000000000000001
1111000000000000000000000000000000000000000000000000000000000000000000000000000000000000000000001
1000000000000000000000000000000010000000000000000000000000000000000000001000000000000000000000001
1111000000000000000000000000000000000000000000000000000000000000000000000000000000000000000111111
1000000000000000000000000000000000000000000000000000000000000000000000000000000000000000000000001
1000000000000000000000000000000000000000000000000000000000000000000000000000000000000000000000001
1111111000000000000000000000000000000000000000000000000000000000000000000000000000000000000111111
1000000000000000000000000000000000000000000000000000000000000000000000000000000000000000000000001
1000000000000000000000000000000000000000000000000000000000000000000000000000000000000000000000001
111100000000000000000000000000000000000000000W000000000000000000000000000000000000000000000011111
1000000000000000000000000000000000000000000000000000000000000000000000000000000000000000000000001
1000000000000000000000000000000000000000000000000000000000000000000000000000000000000000011111111
1000000000000000000000000000000000000000000000000000000000000000000000000000000000000001111111111
1000000000000000000000000000000000000000000000000000000000000000000000100000000000000111111111111
1000000000000000000000000000000000000000000000000000000000000000000000000000000000000011111111111
1110000000000000000000000000000000100000000000000000000000000000000000000000000000000000000111111
1000000000000000000000000000000000000000000000000000000000000000000000000000000000000000000000001
1000000000000000000000000000000000000000000000000000000000000000000000000000000000000000000000001
1111111111111111111111111111111111111111111111111111111111111111111111111111111111111111111111111