NO ./wallTexture/north.png
SO ./wallTexture/south.png
WE ./wallTexture/west.png
EA ./wallTexture/east.png

C 100, 170, 255

F 70, 45,  45




1111111111111111111111111111111111111111111111111111111111111111111111111111111111111111111111111
10000000000000000000000000000000000000000000000000000000000000000000000000000000000000000000000011
100000000000000000000000000010000000000000000000000000000000000000000000000000000000000000000000011
11110000000000000000000000000000000000000000000000000000000000000000000000000000000000000000000000011
1000000000000000000000000000000010000000000000000000000000000000000000001000000000000000000000000011
111100000000000000000000000000000000000000000000000000000000000000000000000000000000000000011111111
1000000000000000000000000000000000000000000000000000000000000000000000000000000000000000000000001
1000000000000000000000000000000000000000000000000000000000000000000000000000000000000000000000001
1111111000000000000000000000000000000000000000000000000000000000000000000000000000000000000111111
1000000000000000000000000000000000000000000000000000NN00000000000000000000000000000000000000000001
1000000000000000000000000000000000000000000000000000000000000000000000000000000000000000000000001
1111000000000000000000000000000000000000000000000000000000000000000000000000000000000000000000111111
1000000000000000000000000000000000000000000000000000000000000000000000000000000000000000000000001
10000000000000000000000000000000000000000000000000000000000000000000000000000000000000000111111111
1000000000000000000000000000000000000000000000000000000000000000000000000000000000000001111
100000000000000000000000000000000000000000000000000000000000000000000010000000000000011111111
1000000000000000000000000000000000000000000000000000000000000000000000000000000000000011111111111111
11100000000000000000000000000000001000000000000000000000000000000000000000000000000000000001111111
1000000000000000000000000000000000000000000000000000000000000000000000000000000000000000000000001
1000000000000000000000000000000000000000000000000000000000000000000000000000000000000000000000001
1111111111111111111111111111111111111111111111111111111111111111111111111111111111111111111111111
